XXXXXXXXXXXXXXXXXXXXXXXXXXXXX
X                           X
X                           X
X            a              X
X                           X
X                           X
X                           X
X                           X
X                           X
X                           X
X                           X
X                           X
X    b       f        c     X
X                           X
X                           X
X                           X
X                           X
X                           X
X                           X
X                           X
X                           X
X                           X
X                           X
X                           X
X           d               X
X                           X
X                           X
X                           X
XXXXXXXXXXXXXXXXXXXXXXXXXXXXX