XXXXXXXXXXXXXXXXXXXXXXXXXXXXX
XXd  X X XdX          d   d X
X           X           d   X
X                           X
Xd     d                    X
XX          XXXXXXXXXXXXXXXXX
X            X         X   fX
X   Xd       X XXX X   Xf   X
X    XXX     X   X X        X
XX           XXXXX XXXXXXXX X
X            X         X    X
X            X X XXXX  X XXXX
XX           X X X     X    X
X              XXXXX   X XX X
X     f        X X X   X X  X
X              X X    X  XX X
XX           X     X  XX X  X
X            X X   X        X
X            X   X X  X XXX X
XX           XXXXX X  X     X
X            X     X   XXXXXX
X    XXX     X XXX XX XXf   X
X   Xa       X     X       fX
XX          XXXXXXXXXXXXXXXXX
Xa     a                    X
X                           X
X           X           a   X
XXa  X X XaX          a   a X
XXXXXXXXXXXXXXXXXXXXXXXXXXXXX